12 12
############
#....===...#
#....#=#...#
#....#=#..@#
#....#=#####
####=#=#####
#..#=====###
#..##=#==###
#...#=#==..#
#....=#==..#
#####=######
#####=######
[break room]
1,1 4,4
[computer room]
8,1 10,3
[guard room]
1,6 2,7
1,8 3,9
4,9 4,9
[bathroom]
9,8 10,9
